languish: ['lose vigor, health, or flesh, as through grief', 'have a desire for something or someone who is not present', 'become feeble']
prototype: ['a standard or typical example']
painstaking: ['characterized by extreme care and great effort']
equanimity: ['steadiness of mind under stress']
passionate: ['having or expressing strong emotions']
lethal: ['of an instrument of certain death']
pacify: ['cause to be more favorably inclined; gain the good will of', 'fight violence and try to establish peace in (a location)']
pragmatic: ['an imperial decree that becomes part of the fundamental law of the land', 'concerned with practical matters', 'of or concerning the theory of pragmatism', 'guided by practical experience and observation rather than theory']
beggary: ['a solicitation for money or food (especially in the street by an apparently penniless person)', 'the state of being a beggar or mendicant']
authenticate: ['establish the authenticity of something']
progressives: ['a tense of verbs used in describing action that is on-going', 'a person who favors a political philosophy of progress and reform and the protection of civil liberties']
condoned: ['excuse, overlook, or make allowances for; be lenient with']
perpetuate: ['cause to continue or prevail']
unwittingly: ['without knowledge or intention']
shrewd: ['marked by practical hardheaded intelligence', 'used of persons']
equitable: ['fair to all parties as dictated by reason and conscience']
exorcise: ['expel through adjuration or prayers']
mumbled: ['talk indistinctly; usually in a low voice', 'grind with the gums; chew without teeth and with great difficulty']
convergence: ['the occurrence of two or more things coming together', 'the approach of an infinite series to a finite limit', 'a representation of common ground between theories or phenomena', 'the act of converging (coming closer)']
abate: ['make less active or intense', 'become less in amount or intensity']
redressed: ['make reparations or amends for']
severity: ['used of the degree of something undesirable e.g. pain or weather', 'something hard to endure', 'extreme plainness', 'excessive sternness']
provocative: ['serving or tending to provoke, excite, or stimulate; stimulating discussion or exciting controversy; ; ; - Anthony Trollope', 'exciting sexual desire']
callous: ['make insensitive or callous; deaden feelings or morals', 'emotionally hardened', 'having calluses; having skin made tough and thick through wear']
indomitable: ['impossible to subdue']
odious: ['unequivocally detestable; ; ; ; - Edmund Burke']
wrath: ['intense anger (usually on an epic scale)', 'belligerence aroused by a real or supposed wrong (personified as one of the deadly sins)']
inopportune: ['not opportune']
peripheral: ['(computer science) electronic equipment connected by cable to the CPU of a computer', 'on or near an edge or constituting an outer boundary; the outer area', 'related to the key issue but not of central importance']
enervating: ['weaken mentally or morally', 'disturb the composure of', 'causing debilitation']
unswerving: ['going directly ahead from one point to another without veering or turning aside', 'firm and dependable especially in loyalty']
fallacy: ['a misconception resulting from incorrect reasoning']
immune: ['a person who is immune to a particular infection', 'relating to the condition of immunity', 'secure against', 'relating to or conferring immunity (to disease or infection)', "(usually followed by `to') not affected by a given influence"]
renaissance: ['the period of European history at the close of the Middle Ages and the rise of the modern world; a cultural rebirth from the 14th through the middle of the 17th centuries', 'the revival of learning and culture']
disparate: ['fundamentally different or distinct in quality or kind', 'including markedly dissimilar elements']
catastrophe: ['an event resulting in great loss and misfortune', 'a state of extreme (usually irremediable) ruin and misfortune', "a sudden violent change in the earth's surface"]
temperate: ['(of weather or climate) free from extremes; mild; or characteristic of such weather or climate', 'not extreme in behavior', 'not extreme']
invaluable: ['having incalculable monetary, intellectual, or spiritual worth']
bellicose: ['having or showing a ready disposition to fight']
indifference: ['unbiased impartial unconcern', 'apathy demonstrated by an absence of emotional reactions', 'the trait of lacking enthusiasm for or interest in things generally', 'the trait of remaining calm and seeming not to care; a casual lack of concern']
loquacious: ['full of trivial conversation']
satiation: ['the state of being satisfactorily full and unable to take on more', 'the act of achieving full gratification']
derogatory: ['expressive of low opinion']
ignoble: ['completely lacking nobility in character or quality or purpose; ; - Oliver Wendell Holmes, Jr.', 'not of the nobility']
defies: ['resist or confront with resistance', 'elude, especially in a baffling way', 'challenge']
accustomed: ['make psychologically or physically used (to something)', "(often followed by `to') in the habit of or adapted to", 'commonly used or practiced; usual']
emasculate: ['deprive of strength or vigor', 'remove the testicles of a male animal', 'having unsuitable feminine qualities']
dissipating: ['to cause to separate and go in different directions', 'move away from each other', 'spend frivolously and unwisely', 'live a life of pleasure, especially with respect to alcoholic consumption']
assiduous: ['marked by care and persistent effort']
vicissitudes: ['a variation in circumstances or fortune at different times in your life or in the development of something', 'mutability in life or nature (especially successive alternation from one condition to another)']
flawless: ['without a flaw']
detriment: ['a damage or loss']
decorous: ['characterized by propriety and dignity and good taste in manners and conduct', 'according with custom or propriety']
taut: ['pulled or drawn tight', 'subjected to great tension; stretched tight']
unfathomable: ['of depth; not capable of being sounded or measured', 'resembling an abyss in depth; so deep as to be unmeasurable', 'impossible to come to understand']
fleeting: ['move along rapidly and lightly; skim or dart', 'disappear gradually', 'lasting for a markedly brief time']
diurnal: ['of or belonging to or active during the day', 'having a daily cycle or occurring every day']
alleviate: ['provide physical relief, as from pain', 'make easier']
renegade: ['someone who rebels and becomes an outlaw', 'a disloyal person who betrays or deserts his cause or religion or political party or friend etc.', 'break with established customs', 'having deserted a cause or principle']
debilitating: ['make weak', 'impairing the strength and vitality']
rescinded: ['cancel officially']
overpriced: ['price excessively high', 'too costly for the value']
predominantly: ['much greater in number or influence']
covert: ['a flock of coots', 'a covering that serves to conceal or shelter something', 'secret or hidden; not openly practiced or engaged in or shown or avowed', '(of a wife) being under the protection of her husband']
sultry: ['sexually exciting or gratifying', 'characterized by oppressive heat and humidity']
arduous: ['characterized by effort to the point of exhaustion; especially physical effort', 'taxing to the utmost; testing powers of endurance; ; ; - F.D.Roosevelt', 'difficult to accomplish; demanding considerable mental effort and skill']
harmless: ['not causing or capable of causing harm']
naivety: ['lack of sophistication or worldliness']
inconceivable: ['totally unlikely']
ambivalent: ['uncertain or unable to decide about what course to follow']
rudiments: ['a statement of fundamental facts or principles', 'the elementary stages of any subject (usually plural)', 'the remains of a body part that was functional at an earlier stage of life']
plethora: ['extreme excess']
agog: ['highly excited']
interminable: ['tiresomely long; seemingly without end']
youthfulness: ['the freshness and vitality characteristic of a young person']
apathy: ['an absence of emotion or enthusiasm', 'the trait of lacking enthusiasm for or interest in things generally']
averred: ['report or maintain', 'to declare or affirm solemnly and formally as true']
frugality: ['prudence in avoiding waste']
underscores: ['a line drawn underneath (especially under written matter)', 'give extra weight to (a communication)', 'draw a line or lines underneath to call attention to']
adroit: ['quick or skillful or adept in action or thought']
ignoble: ['completely lacking nobility in character or quality or purpose; ; - Oliver Wendell Holmes, Jr.', 'not of the nobility']
notorious: ['known widely and usually unfavorably']
redounds to: []
phlegmatic: ['showing little emotion']
restive: ['being in a tense state', 'impatient especially under restriction or delay']
unprecedented: ['having no precedent; novel']
indomitable: ['impossible to subdue']
incontrovertible: ['impossible to deny or disprove', 'necessarily or demonstrably true']
extemporaneous: ['with little or no preparation or forethought']
gullible: ['naive and easily deceived or tricked', 'easily tricked because of being too trusting']
inordinate: ['beyond normal limits']
timid: ['people who are fearful and cautious', 'showing fear and lack of confidence', 'lacking self-confidence', 'lacking conviction or boldness or courage']
conceal: ['prevent from being seen or discovered', 'hold back; keep from being perceived by others']
inspired: ['heighten or intensify', 'supply the inspiration for', 'serve as the inciting cause of', 'spur on or encourage especially by cheers and shouts', 'fill with revolutionary ideas', 'draw in (air)', 'being of such surpassing excellence as to suggest inspiration by the gods']
ecstatic: ['feeling great rapture or delight']
recalcitrant: ['stubbornly resistant to authority or control', 'marked by stubborn resistance to authority']
invigorating: ['heighten or intensify', 'give life or energy to', 'make lively', 'impart vigor, strength, or vitality to', 'imparting strength and vitality']
loath: ['unwillingness to do something contrary to your custom', "(usually followed by `to') strongly opposed"]
trepidation: ['a feeling of alarm or dread']
finesse: ['subtly skillful handling of a situation']
presently: ['in the near future', 'at this time or period; now']
characteristically: ['in characteristic manner']
chagrin: ['strong feelings of embarrassment', 'cause to feel shame; hurt the pride of']
momentous: ['of very great significance']
classified: ['a short ad in a newspaper or magazine (usually in small print) and appearing along with other ads of the same type', 'arrange or order by classes or categories', 'declare unavailable, as for security reasons', 'assign to a class or kind', 'arranged into classes', 'official classification of information or documents; withheld from general circulation']
prophylactic: ['remedy that prevents or slows the course of an illness or disease', 'contraceptive device consisting of a sheath of thin rubber or latex that is worn over the penis during intercourse', 'capable of preventing conception or impregnation', 'warding off; - Victor Schultze', 'preventing or contributing to the prevention of disease']
mooted: ['think about carefully; weigh']
incisive: ['having or demonstrating ability to recognize or draw fine distinctions', 'suitable for cutting or piercing']
inured: ['cause to accept or become hardened to; habituate', 'made tough by habitual exposure; ; - Robert Lynd; - V.S.Pritchett']
venal: ['capable of being corrupted']
nefarious: ['extremely wicked']
aggravated: ['make worse', 'exasperate or irritate', 'made more severe or intense especially in law', 'incited, especially deliberately, to anger']
evasive: ['deliberately vague or ambiguous', 'avoiding or escaping from difficulty or danger especially enemy fire']
enchanting: ['hold spellbound', 'attract; cause to be enamored', 'cast a spell over someone or something; put a hex on someone or something', 'capturing interest as if by a spell']
eclectic: ['someone who selects according to the eclectic method', 'selecting what seems best of various styles or ideas']
brain wave: []
gait: ['the rate of moving (especially walking or running)', "a horse's manner of moving", "a person's manner of walking"]
repudiated: ['cast off', 'refuse to acknowledge, ratify, or recognize as valid', 'refuse to recognize or pay', 'reject as untrue, unfounded, or unjust']
profusely: ['in an abundant manner']
obstructing: ['hinder or prevent the progress or accomplishment of', 'block passage through', 'shut out from view or get in the way so as to hide from sight']
egalitarianism: ['the doctrine of the equality of mankind and the desirability of political and economic and social equality']
incentive: ['a positive motivational influence', 'an additional payment (or other remuneration) to employees as a means of increasing output']
a doting: []
feasibility: ['the quality of being doable']
credentials: ['a document attesting to the truth of certain stated facts', 'a document attesting to the truth of certain stated facts']
restive: ['being in a tense state', 'impatient especially under restriction or delay']
dexterity: ['adroitness in using the hands']
circumvent: ['surround so as to force to give up', 'beat through cleverness and wit', 'avoid or try to avoid fulfilling, answering, or performing (duties, questions, or issues)']
fatal: ['bringing death', 'having momentous consequences; of decisive importance; - Saturday Rev', '(of events) having extremely unfortunate or dire consequences; bringing ruin; ; ; ; - Charles Darwin; - Douglas MacArthur', 'controlled or decreed by fate; predetermined']
several: ['(used with count nouns) of an indefinite number more than 2 or 3 but not many', 'considered individually', 'distinct and individual']
serious: ['concerned with work or important matters rather than play or trivialities', 'of great consequence', 'causing fear or anxiety by threatening great harm', 'appealing to the mind', 'completely lacking in playfulness', 'requiring effort or concentration; complex and not easy to answer or solve']
nebulous: ['lacking definite form or limits; - H.T.Moore', 'of or relating to or resembling a nebula', 'lacking definition or definite content; ; - Jane Austen']
impassioned: ['characterized by intense emotion']
euphoria: ['a feeling of great (usually exaggerated) elation']
alienated: ['arouse hostility or indifference in where there had formerly been love, affection, or friendliness', 'transfer property or ownership', 'make withdrawn or isolated or emotionally dissociated', 'socially disoriented', 'caused to be unloved']
sympathetic: ['of or relating to the sympathetic nervous system', 'expressing or feeling or resulting from sympathy or compassion or friendly fellow feelings; disposed toward', 'showing or motivated by sympathy and understanding and generosity', '(of characters in literature or drama) evoking empathic or sympathetic feelings', 'having similar disposition and tastes', 'relating to vibrations that occur as a result of vibrations in a nearby body']
browbeating: ['be bossy towards', 'discourage or frighten with threats or a domineering manner; intimidate']
coalescence: ['the union of diverse things into one body or form or group; the growing together of parts']
gamely: ['in a plucky manner']
reverse: ['a relation of direct opposition', 'the gears by which the motion of a machine can be reversed', 'an unfortunate happening that hinders or impedes; something that is thwarting or frustrating', 'the side of a coin or medal that does not bear the principal design', '(American football) a running play in which a back running in one direction hands the ball to a back running in the opposite direction', 'turning in the opposite direction', 'change to the contrary', 'turn inside out or upside down', 'rule against', 'cancel officially', 'reverse the position, order, relation, or condition of', 'directed or moving toward the rear', 'of the transmission gear causing backward movement in a motor vehicle', 'reversed (turned backward) in order or nature or effect']
moribund: ['not growing or changing; without force or vitality', 'being on the point of death; breathing your last']
sumptuous: ['rich and superior in quality']
facetious: ['cleverly amusing in tone']
abstruse: ['difficult to penetrate; incomprehensible to one of ordinary understanding or knowledge']
belligerent: ['someone who fights (or is fighting)', 'characteristic of an enemy or one eager to fight', 'engaged in war']
tardy: ['after the expected or usual time; delayed']
complacently: ['in a self-satisfied manner']
timorous: ['timid by nature or revealing timidity']
pilferer: ['a thief who steals without using violence']
think: ['an instance of deliberate thinking', 'judge or regard; look upon; judge', 'expect, believe, or suppose', "use or exercise the mind or one's power of reason in order to make inferences, decisions, or arrive at a solution or judgments", 'recall knowledge from memory; have a recollection', 'imagine or visualize', "focus one's attention on a certain state", 'have in mind as a purpose', 'decide by pondering, reasoning, or reflecting', 'ponder; reflect on, or reason about', 'dispose the mind in a certain way', 'have or formulate in the mind', 'be capable of conscious thought', 'bring into a given condition by mental preoccupation']
stringer: ['a member of a squad on a team', 'a worker who strings', 'brace consisting of a longitudinal member to strengthen a fuselage or hull', 'a long horizontal timber to connect uprights']
disparaging: ['express a negative opinion of', 'expressive of low opinion']
adamant about: []
reprisal: ['a retaliatory action against an enemy in wartime']
eerie: ['suggestive of the supernatural; mysterious', 'inspiring a feeling of fear; strange and frightening']
therapeutic: ['a medicine or therapy that cures disease or relieve pain', 'tending to cure or restore to health', 'relating to or involved in therapy']
puerile: ['of or characteristic of a child', 'displaying or suggesting a lack of maturity']
extraneous: ['not pertinent to the matter under consideration', 'not essential', 'not belonging to that in which it is contained; introduced from an outside source', 'coming from the outside']
pyrrhic: ['a metrical unit with unstressed-unstressed syllables', 'an ancient Greek dance imitating the motions of warfare', 'of or relating to a war dance of ancient Greece', 'of or relating to or containing a metrical foot of two unstressed syllables', 'of or relating to or resembling Pyrrhus or his exploits (especially his sustaining staggering losses in order to defeat the Romans)']
miscontrued: []
luminaries: ['a celebrity who is an inspiration to others']
assumed: ['take to be the case or to be true; accept without verification or proof', 'take on titles, offices, duties, responsibilities', 'take on a certain form, attribute, or aspect', "take on as one's own the expenses or debts of another person", 'occupy or take on', "seize and take control without authority and possibly with force; take as one's right or possession", 'make a pretence of', "take up someone's soul into heaven", "put clothing on one's body", 'adopted in order to deceive']
unstinting: ['very generous']
vilified: ['spread negative information about']
glut: ['the quality of being so overabundant that prices fall', 'overeat or eat immodestly; make a pig of oneself', 'supply with an excess of']
imminent: ['close in time; about to occur']
cynics: ['someone who is critical of the motives of others', 'a member of a group of ancient Greek philosophers who advocated the doctrine that virtue is the only good and that the essence of virtue is self-control']
essence: ['the choicest or most essential or most vital part of some idea or experience', 'any substance possessing to a high degree the predominant properties of a plant or drug or other natural product from which it is extracted', 'the central meaning or theme of a speech or literary work', 'a toiletry that emits and diffuses a fragrant odor']
infer: ['reason by deduction; establish by deduction', 'draw from specific cases for more general cases', 'conclude by reasoning; in logic', 'guess correctly; solve by guessing', 'believe to be the case']
nauseating: ['upset and make nauseated', 'cause aversion in; offend the moral sense of', 'causing or able to cause nausea']
commodious: ["large and roomy (`convenient' is archaic in this sense)"]
plausible: ['apparently reasonable and valid, and truthful', 'given to or characterized by presenting specious arguments']
substantiate: ['establish or strengthen as with new evidence or facts', 'represent in bodily form', 'make real or concrete; give reality or substance to', 'solidify, firm, or strengthen']
levity: ['feeling an inappropriate lack of seriousness', 'a manner lacking seriousness']
liberality: ['an inclination to favor progress and individual freedom', 'the trait of being generous in behavior and temperament']
heritage: ['practices that are handed down from the past by tradition', 'any attribute or immaterial possession that is inherited from ancestors', 'that which is inherited; a title or property or estate that passes by law to the heir on the death of the owner', 'hereditary succession to a title or an office or property']
utmost: ['the greatest possible degree', 'of the greatest possible degree or extent or intensity', 'highest in extent or degree', "(comparatives of `far') most remote in space or time or order"]
insignia: ['a badge worn to show official position']
mottled: ['mark with spots or blotches of different color or shades of color as if stained', 'colour with streaks or blotches of different shades', 'having spots or patches of color']
pejorative: ['expressing disapproval']
Funnily enough: []
boomeranged: ['return to the initial position from where it came; like a boomerang']
realistic: ['aware or expressing awareness of things as they really are', 'representing what is real; not abstract or ideal', 'of or relating to the philosophical doctrine of realism']
fateful: ['having momentous consequences; of decisive importance; - Saturday Rev', 'ominously prophetic', '(of events) having extremely unfortunate or dire consequences; bringing ruin; ; ; ; - Charles Darwin; - Douglas MacArthur', 'controlled or decreed by fate; predetermined']
lively: ['full of life and energy', 'full of zest or vigor', 'quick and energetic', 'elastic; rebounds readily', 'filled with events or activity', 'full of spirit']
observant: ['paying close attention especially to details', 'quick to notice; showing quick and keen perception', '(of individuals) adhering strictly to laws and rules and customs']
common: ['a piece of open land for recreational use in an urban area', 'belonging to or participated in by a community as a whole; public', 'having no special distinction or quality; widely known or commonly encountered; average or ordinary or usual', 'common to or shared by two or more parties', 'commonly encountered', 'being or characteristic of or appropriate to everyday language', 'of or associated with the great masses of people', 'of low or inferior quality or value; - Shakespeare', 'lacking refinement or cultivation or taste', 'to be expected; standard']
inexpressible: ['defying expression']
superficial: ['concerned with or comprehending only what is apparent or obvious; not deep or penetrating emotionally or intellectually', 'of, affecting, or being on or near the surface', 'of little substance or significance']
vital: ['urgently needed; absolutely necessary', 'performing an essential function in the living body', 'full of spirit', 'manifesting or characteristic of life']
poverty: ['the state of having little or no money and few or no material possessions']
Courteously: ['in a polite manner']
taciturnity: ['the trait of being uncommunicative; not volunteering anything more than necessary']
Accountability: ['responsibility to someone or for some activity']
sanctioned: ['give sanction to', 'give authority or permission to', 'give religious sanction to, such as through on oath', 'conforming to orthodox or recognized rules; - Sinclair Lewis', 'formally approved and invested with legal authority', 'established by authority; given authoritative approval']
monstrous: ['abnormally large', 'shockingly brutal or cruel', 'distorted and unnatural in shape or size; abnormal and hideous']
meddlesome: ['intrusive in a meddling or offensive manner']
relentless: ['not to be placated or appeased or moved by entreaty', 'never-ceasing']
preparedness: ['the state of having been made ready or prepared for use or action (especially military action)']
convention: ['a large formal assembly', 'something regarded as a normative example', '(diplomacy) an international agreement', 'orthodoxy as a consequence of being conventional', 'the act of convening']
redeemable: ['recoverable upon payment or fulfilling a condition', 'able to be converted into ready money or the equivalent', 'susceptible to improvement or reform']
awry: ['turned or twisted toward one side; - G.K.Chesterton', 'not functioning properly', 'away from the correct or expected course', 'turned or twisted to one side']
morbid: ['suggesting an unhealthy mental state', 'suggesting the horror of death and decay', 'caused by or altered by or manifesting disease or pathology']
a convoluted: []
reveled: ['take delight in', 'celebrate noisily, often indulging in drinking; engage in uproarious festivities']
retract: ['formally reject or disavow a formerly held belief, usually under pressure', 'pull away from a source of disgust or fear', 'use a surgical instrument to hold open (the edges of a wound or an organ)', 'pull inward or towards a center']
arbitration: ['(law) the hearing and determination of a dispute by an impartial referee agreed to by both parties (often used to settle disputes between labor and management)', 'the act of deciding as an arbiter; giving authoritative judgment']
withstand: ['resist or confront with resistance', 'stand up or offer resistance to somebody or something']
biased: ['influence in an unfair way', 'cause to be biased', 'favoring one person or side over another']
exacting: ['claim as due or just', 'take as an undesirable consequence of some event or state of affairs', 'having complicated nutritional requirements; especially growing only in special artificial cultures', 'severe and unremitting in making demands', 'requiring precise accuracy']
remonstrances: ['the act of expressing earnest opposition or protest']
throng: ['a large gathering of people', 'press tightly together or cram']
misgivings: ['uneasiness about the fitness of an action', 'painful expectation', "doubt about someone's honesty", 'suggest fear or doubt']
maladies: ['any unwholesome or desperate condition', 'impairment of normal physiological function affecting part or all of an organism']
camaraderie: ['the quality of affording easy familiarity and sociability']
posterity: ['all of the offspring of a given progenitor', 'all future generations']
commands: ['an authoritative direction or instruction to do something', 'a military unit or region under the control of a single officer', 'the power or authority to command', 'availability for use', 'a position of highest authority', 'great skillfulness and knowledge of some subject or activity', '(computer science) a line of code written as part of a computer program', 'be in command of', 'make someone do something', "demand as one's due", 'look down on', 'exercise authoritative control or power over']
laudable: ['worthy of high praise']
stern: ['the rear part of a ship', 'United States concert violinist (born in Russia in 1920)', 'the fleshy part of the human body that you sit on', 'of a stern or strict bearing or demeanor; forbidding in aspect', 'not to be placated or appeased or moved by entreaty', 'severe and unremitting in making demands', 'severely simple']
altercation: ['noisy quarrel']
inscrutable: ['of an obscure nature; ; ; ; - Rachel Carson']
specious: ['plausible but false', 'based on pretense; deceptively pleasing']
livery: ['uniform worn by some menservants and chauffeurs', 'the voluntary transfer of something (title or possession) from one party to another', 'the care (feeding and stabling) of horses for pay', 'suffering from or suggesting a liver disorder or gastric distress']
sinister: ['threatening or foreshadowing evil or tragic developments', 'stemming from evil characteristics or forces; wicked or dishonorable; ; ; ; ; ; ; -Thomas Hardy', "on or starting from the wearer's left"]
unification: ['an occurrence that involves the production of a union', 'the state of being joined or united or linked', 'the act of making or becoming a single unit']
forbearance: ['good-natured tolerance of delay or incompetence', 'a delay in enforcing rights or claims or privileges; refraining from acting']
implication: ['something that is inferred (deduced or entailed or implied)', 'a meaning that is not expressly stated but can be inferred', 'an accusation that brings into intimate and usually incriminating connection', "a logical relation between propositions p and q of the form `if p then q'; if p is true then q cannot be false", 'a relation implicated by virtue of involvement or close connection (especially an incriminating involvement)']
impasse: ['a situation in which no progress can be made or no advancement is possible', 'a street with only one way in or out']
enthusiastic: ['having or showing great excitement and interest']
absurd: ['a situation in which life seems irrational and meaningless; --Albert Camus', 'inconsistent with reason or logic or common sense; - Walter Lippman', 'incongruous;inviting ridicule']
tardy: ['after the expected or usual time; delayed']
sumptuous: ['rich and superior in quality']
panacea: ['(Greek mythology) the goddess of healing; daughter of Aesculapius and sister of Hygeia', 'hypothetical remedy for all ills or diseases; once sought by the alchemists']
retrenchment: ['entrenchment consisting of an additional interior fortification to prolong the defense', 'the reduction of expenditures in order to become financially stable']
offhand: ['with little or no preparation or forethought', 'casually thoughtless or inconsiderate', 'without previous thought or preparation', 'in a casually inconsiderate manner']
assortment: ['a collection containing a variety of sorts of things', 'the act of distributing things into classes or categories of the same type']
astounded: ['affect with wonder', 'filled with the emotional impact of overwhelming surprise or shock']
apposite: ['being of striking appropriateness and pertinence']
blemish: ["a mark or flaw that spoils the appearance of something (especially on a person's body)", 'mar or spoil the appearance of', 'mar or impair with a flaw', 'add a flaw or blemish to; make imperfect or defective']
eligible: ['qualified for or allowed or worthy of being chosen']
abridged: ['reduce in scope while retaining essential elements', 'lessen, diminish, or curtail', '(used of texts) shortened by condensing or rewriting']
inception: ['an event that is a beginning; a first part or stage of subsequent events']
detached: ['cause to become detached or separated; take off', 'separate (a small unit) from a larger, especially for a special assignment', 'come to be detached', 'showing lack of emotional involvement; - J.S.Perelman', 'being or feeling set or kept apart from others; ; - Sherwood Anderson', 'no longer connected or joined', 'used of buildings; standing apart from others', 'lacking affection or warm feeling', 'not fixed in position']
dwelt: ['think moodily or anxiously about something', 'originate (in)', 'inhabit or live in; be an inhabitant of', 'exist or be situated within', 'come back to']
ignominious: ['(used of conduct or character) deserving or bringing disgrace or shame; - Rachel Carson']
compliments: ["(usually plural) a polite expression of desire for someone's welfare", 'a remark (or act) expressing praise and admiration', 'say something to someone that expresses praise', 'express respect or esteem for']
ensnared: ['take or catch as if in a snare or trap', 'catch in or as if in a trap']
astute: ['marked by practical hardheaded intelligence']
tactful: ['having or showing a sense of what is fitting and considerate in dealing with others', 'showing skill and sensitivity in dealing with people']
dementia: ['mental deterioration of organic or functional origin']
deleterous: []
belligerent: ['someone who fights (or is fighting)', 'characteristic of an enemy or one eager to fight', 'engaged in war']
supersedes: ['take the place or move into the position of']
corrugated: ['fold into ridges', 'shaped into alternating parallel grooves and ridges']
exacerbated: ['make worse', 'exasperate or irritate']
derogatory: ['expressive of low opinion']
sovereignty: ['government free from external control', 'royal authority; the dominion of a monarch', 'the authority of a state to govern another state']
virtuous: ['morally excellent', 'in a state of sexual virginity']
typical: ['exhibiting the qualities or characteristics that identify a group or kind or category', 'of a feature that helps to distinguish a person or thing; - Curtis Wilkie', 'conforming to a type']
pretified: []
shimmers: ['a weak and tremulous light', 'shine with a weak or fitful light', 'give off a shimmering reflection, as of silk']
vulnerable: ['susceptible to attack', 'susceptible to criticism or persuasion or temptation', 'capable of being wounded or hurt']
furtive: ['marked by quiet and caution and secrecy; taking pains to avoid being observed', 'secret and sly or sordid; ; - A.L.Guerard']
espoused: ['choose and follow; as of theories, ideas, policies, strategies or plans', 'take in marriage', "take up the cause, ideology, practice, method, of someone and use it as one's own"]
foreclose: ['keep from happening or arising; make impossible', 'subject to foreclosing procedures; take away the right of mortgagors to redeem their mortgage']
exploded: ['cause to burst with a violent release of energy', 'burst outward, usually with noise', 'show a violent emotional reaction', 'be unleashed; emerge with violence or noise', 'destroy by exploding', 'cause to burst as a result of air pressure; of stop consonants like /p/, /t/, and /k/', 'drive from the stage by noisy disapproval', 'show (a theory or claim) to be baseless, or refute and make obsolete', 'burst and release energy as through a violent chemical or physical reaction', 'increase rapidly and in an uncontrolled manner', 'showing the parts of something separated but in positions that show their correct relation to one another']
incessant: ['uninterrupted in time and indefinitely long continuing']
favorable: ['encouraging or approving or pleasing', '(of winds or weather) tending to promote or facilitate', 'presaging or likely to bring good luck', 'inclined to help or support; not antagonistic or hostile', 'occurring at a convenient or suitable time']
aghast: ['struck with fear, dread, or consternation']
jaunty: ['marked by up-to-dateness in dress and manners', 'having a cheerful, lively, and self-confident air; - Frances G. Patton; - H.M.Reynolds']
doddle: ['an easy task']
lustful: ['characterized by lust', 'driven by lust; preoccupied with or exhibiting lustful desires', 'vigorously passionate']
fomenting: ['try to stir up public opinion', 'bathe with warm water or medicated lotions']
learn: ['gain knowledge or skills', 'get to know or become aware of, usually accidentally', 'commit to memory; learn by heart', 'be a student of a certain subject', 'impart skills or knowledge to', 'find out, learn, or determine with certainty, usually by making an inquiry or other effort']
garner: ['a storehouse for threshed grain or animal feed', "acquire or deserve by one's efforts or actions", 'store grain', 'assemble or get together']
severing: ['the act of severing', 'set or keep apart', 'cut off from a whole']
gruff: ['brusque and surly and forbidding', 'deep and harsh sounding as if from shouting or illness or emotion; ; ; ; - Virgil Thomson']
fraught: ['marked by distress', 'filled with or attended with']
scowled: ['frown with displeasure']
obviate: ['do away with', 'prevent the occurrence of; prevent from happening']
hoodwinked: ['influence by slyness', "conceal one's true motives from especially by elaborately feigning good intentions so as to gain an end"]
gaiety: ['a gay feeling', 'a festive merry feeling']
pungent: ['strong and sharp', 'capable of wounding']
languid: ['lacking spirit or liveliness']
heckled: ['comb with a heckle', 'challenge aggressively']
restive: ['being in a tense state', 'impatient especially under restriction or delay']
impromptu: ['an extemporaneous speech or remark', 'a short musical passage that seems to have been made spontaneously without advance preparation', 'with little or no preparation or forethought', 'without advance preparation']
maligned: ['speak unfavorably about']
cogent: ['powerfully persuasive']
attune: ['adjust or accustom to; bring into harmony with']
averred: ['report or maintain', 'to declare or affirm solemnly and formally as true']
frugality: ['prudence in avoiding waste']
underscores: ['a line drawn underneath (especially under written matter)', 'give extra weight to (a communication)', 'draw a line or lines underneath to call attention to']
adroit: ['quick or skillful or adept in action or thought']
ignoble: ['completely lacking nobility in character or quality or purpose; ; - Oliver Wendell Holmes, Jr.', 'not of the nobility']
sanctioned: ['give sanction to', 'give authority or permission to', 'give religious sanction to, such as through on oath', 'conforming to orthodox or recognized rules; - Sinclair Lewis', 'formally approved and invested with legal authority', 'established by authority; given authoritative approval']
offended: ['cause to feel resentment or indignation', 'act in disregard of laws, rules, contracts, or promises', 'strike with disgust or revulsion', 'hurt the feelings of', 'hurt or upset']
monstrous: ['abnormally large', 'shockingly brutal or cruel', 'distorted and unnatural in shape or size; abnormal and hideous']
soothe: ['give moral or emotional strength to', 'cause to feel better']
phantom: ['a ghostly appearing figure', 'something existing in perception only', 'something apparently sensed but having no physical reality']
repugnant: ['offensive to the mind']
optional: ['possible but not necessary; left to personal choice']
waned: ['grow smaller', 'become smaller', 'decrease in phase', 'become pale and sickly']
stealthily: ['in a stealthy manner']
chattered: ['click repeatedly or uncontrollably', 'cut unevenly with a chattering tool', 'talk socially without exchanging too much information', 'speak (about unimportant matters) rapidly and incessantly', 'make noise as if chattering away']
FEROCIOUS: ['marked by extreme and violent energy']
METEORIC: ['of or pertaining to atmospheric phenomena, especially weather and weather conditions', 'pertaining to or consisting of meteors or meteoroids', 'like a meteor in speed or brilliance or transience']
OBLIVION: ['the state of being disregarded or forgotten', 'total forgetfulness']
pilferer: ['a thief who steals without using violence']
belligerent: ['someone who fights (or is fighting)', 'characteristic of an enemy or one eager to fight', 'engaged in war']
timorous: ['timid by nature or revealing timidity']
ably: ['with competence; in a competent capable manner']
wee: ['a short time', 'eliminate urine', '(used informally) very small', 'very early']
fiscal: ['involving financial matters']
abrasive: ['a substance that abrades or wears down', 'causing abrasion', 'sharply disagreeable; rigorous']
abreast: ['being up to particular standard or level especially in being up to date in knowledge', 'alongside each other, facing in the same direction']
